  ________________________
 / \----------------------\ 
 \_,|                     | 
    |                     | 
    |                     | 
    |                     | 
    |                     | 
    |  ,--------------------
    \_/___________________/ 